||||||||||||||||||||||||||||
|************||************|
|*||||*|||||*||*|||||*||||*|
|*|  |*|   |*||*|   |*|  |*|
|*||||*|||||*||*|||||*||||*|
|**************************|
|*||||*||*||||||||*||*||||*|
|*||||*||*||||||||*||*||||*|
|******||****||****||******|
||||||*||||| || |||||*||||||
     |*||||| || |||||*|     
     |*||          ||*|     
     |*|| |||||||| ||*|
||||||*|| |      | ||*||||||
      *   |      |   *      
||||||*|| |      | ||*||||||
     |*|| |||||||| ||*|     
     |*||          ||*|     
     |*|| |||||||| ||*|     
||||||*|| |||||||| ||*||||||
|************||************|
|*||||*|||||*||*|||||*||||*|
|*||||*|||||*||*|||||*||||*|
|***||****************||***|
|||*||*||*||||||||*||*||*|||
|||*||*||*||||||||*||*||*|||
|******||****||****||******|
|*||||||||||*||*||||||||||*|
|*|        |*||*|        |*|
|*||||||||||*||*||||||||||*|
|**************************|
||||||||||||||||||||||||||||
