||||||||||||||||||||||||||||
||||||||||||||||||||||||||||
|************||************|
|*||||*|||||*||*|||||*||||*|
|$|  |*|   |*||*|   |*|  |$|
|*||||*|||||*||*|||||*||||*|
|**************************|
|*||||*||*||||||||*||*||||*|
|*||||*||*||||||||*||*||||*|
|******||****||****||******|
||||||*||||| || |||||*||||||
     |*||||| || |||||*|
     |*||          ||*|
     |*|| |||||||| ||*|
||||||*|| |      | ||*||||||
¦     *   |      |   *     ¦
||||||*|| |      | ||*||||||
     |*|| |||||||| ||*|
     |*||          ||*|
     |*|| |||||||| ||*|
||||||*|| |||||||| ||*||||||
|************||************|
|*||||*|||||*||*|||||*||||*|
|$||||*|||||*||*|||||*||||$|
|***||****************||***|
|||*||*||*||||||||*||*||*|||
|||*||*||*||||||||*||*||*|||
|******||****||****||******|
|*||||||||||*||*||||||||||*|
|*|        |*||*|        |*|
|*||||||||||*||*||||||||||*|
|**************************|
||||||||||||||||||||||||||||
||||||||||||||||||||||||||||