1111111111111111111111111111
1333333333333113333333333331
1311113111113113111113111131
1310013100013113100013100131
1311113111113113111113111131
1333333333333333333333333331
1311113113111111113113111131
1311113113111111113113111131
1333333113333113333113333331
1111113111110110111113111111
0000013111110110111113100000
0000013110000000000113100000
0000013110111221110113100000
1111113110100000010113111111
0000003000100000010003000000
1111113110100000010113111111
0000013110111111110113100000
0000013110000000000113100000
0000013110111111110113100000
1111113110111111110113111111
1333333333333113333333333331
1311113111113113111113111131
1311113111113113111113111131
1333113333333333333333113331
1113113113111111113113113111
1113113113111111113113113111
1333333113333113333113333331
1311111111113113111111111131
1310000000013113100000000131
1311111111113113111111111131
1333333333333333333333333331
1111111111111111111111111111
